LINK 0-14 27-14
LINK 27-14 0-14
PSTART 14-23
BLINKY_START 12-14
PINKY_START 13-14
INKY_START 14-14
CLYDE_START 15-14
SP 6-5
SP 21-5
SP 6-23
SP 21-23
TEXTURE rsrc/pacman/texture/pacmap.png
MAP_BEGIN
1 1 1 1 1 1 1 1 1 1 1 1 1 1 1 1 1 1 1 1 1 1 1 1 1 1 1 1
1 6 6 6 6 6 6 6 6 6 6 6 6 1 1 6 6 6 6 6 6 6 6 6 6 6 6 1
1 6 1 1 1 1 6 1 1 1 1 1 6 1 1 6 1 1 1 1 1 6 1 1 1 1 6 1
1 6 1 0 0 1 6 1 0 0 0 1 6 1 1 6 1 0 0 0 1 6 1 0 0 1 6 1
1 6 1 1 1 1 6 1 1 1 1 1 6 1 1 6 1 1 1 1 1 6 1 1 1 1 6 1
1 6 6 6 6 6 6 6 6 6 6 6 6 6 6 6 6 6 6 6 6 6 6 6 6 6 6 1
1 6 1 1 1 1 6 1 1 6 1 1 1 1 1 1 1 1 6 1 1 6 1 1 1 1 6 1
1 6 1 1 1 1 6 1 1 6 1 1 1 1 1 1 1 1 6 1 1 6 1 1 1 1 6 1
1 6 6 6 6 6 6 1 1 6 6 6 6 1 1 6 6 6 6 1 1 6 6 6 6 6 6 1
1 1 1 1 1 1 6 1 1 1 1 1 0 1 1 0 1 1 1 1 1 6 1 1 1 1 1 1
0 0 0 0 0 1 6 1 1 1 1 1 0 1 1 0 1 1 1 1 1 6 1 0 0 0 0 0
0 0 0 0 0 1 6 1 1 0 0 0 0 0 0 0 0 0 0 1 1 6 1 0 0 0 0 0
0 0 0 0 0 1 6 1 1 0 1 1 1 0 0 1 1 1 0 1 1 6 1 0 0 0 0 0
1 1 1 1 1 1 6 1 1 0 1 0 0 0 0 0 0 1 0 1 1 6 1 1 1 1 1 1
0 0 0 0 0 0 6 0 0 0 1 0 0 0 0 0 0 1 0 0 0 6 0 0 0 0 0 0
1 1 1 1 1 1 6 1 1 0 1 0 0 0 0 0 0 1 0 1 1 6 1 1 1 1 1 1
0 0 0 0 0 1 6 1 1 0 1 1 1 1 1 1 1 1 0 1 1 6 1 0 0 0 0 0
0 0 0 0 0 1 6 1 1 0 0 0 0 0 0 0 0 0 0 1 1 6 1 0 0 0 0 0
0 0 0 0 0 1 6 1 1 0 1 1 1 1 1 1 1 1 0 1 1 6 1 0 0 0 0 0
1 1 1 1 1 1 6 1 1 0 1 1 1 1 1 1 1 1 0 1 1 6 1 1 1 1 1 1
1 6 6 6 6 6 6 6 6 6 6 6 6 1 1 6 6 6 6 6 6 6 6 6 6 6 6 1
1 6 1 1 1 1 6 1 1 1 1 1 6 1 1 6 1 1 1 1 1 6 1 1 1 1 6 1
1 6 1 1 1 1 6 1 1 1 1 1 6 1 1 6 1 1 1 1 1 6 1 1 1 1 6 1
1 6 6 6 1 1 6 6 6 6 6 6 6 6 0 6 6 6 6 6 6 6 1 1 6 6 6 1
1 1 1 6 1 1 6 1 1 6 1 1 1 1 1 1 1 1 6 1 1 6 1 1 6 1 1 1
1 1 1 6 1 1 6 1 1 6 1 1 1 1 1 1 1 1 6 1 1 6 1 1 6 1 1 1
1 6 6 6 6 6 6 1 1 6 6 6 6 1 1 6 6 6 6 1 1 6 6 6 6 6 6 1
1 6 1 1 1 1 1 1 1 1 1 1 6 1 1 6 1 1 1 1 1 1 1 1 1 1 6 1
1 6 1 1 1 1 1 1 1 1 1 1 6 1 1 6 1 1 1 1 1 1 1 1 1 1 6 1
1 6 6 6 6 6 6 6 6 6 6 6 6 6 6 6 6 6 6 6 6 6 6 6 6 6 6 1
1 1 1 1 1 1 1 1 1 1 1 1 1 1 1 1 1 1 1 1 1 1 1 1 1 1 1 1
MAP_END